"filename", "language", "Shell Script", "Go", "PowerShell", "comment", "blank", "total"
"d:\25cxx\try\v1\cmd\client\main.go", "Go", 0, 12, 0, 1, 1, 14
"d:\25cxx\try\v1\gatesvr\proto\message.pb.go", "Go", 0, 227, 0, 11, 36, 274
"d:\25cxx\try\v1\gatesvr\proto\upstream.pb.go", "Go", 0, -558, 0, -20, -87, -665
"d:\25cxx\try\v1\gatesvr\proto\upstream_grpc.pb.go", "Go", 0, -27, 0, -4, -4, -35
"d:\25cxx\try\v1\internal\client\client.go", "Go", 0, 66, 0, 13, 22, 101
"d:\25cxx\try\v1\internal\gateway\handlers.go", "Go", 0, 68, 0, 12, 15, 95
"d:\25cxx\try\v1\internal\gateway\push_client.go", "Go", 0, -292, 0, -43, -79, -414
"d:\25cxx\try\v1\internal\gateway\server.go", "Go", 0, -21, 0, -4, -5, -30
"d:\25cxx\try\v1\internal\gateway\server_connection.go", "Go", 0, 4, 0, 0, 0, 4
"d:\25cxx\try\v1\internal\gateway\server_push.go", "Go", 0, -13, 0, 15, -2, 0
"d:\25cxx\try\v1\internal\gateway\server_upstream.go", "Go", 0, -80, 0, -18, -21, -119
"d:\25cxx\try\v1\internal\message\codec.go", "Go", 0, 45, 0, 3, 9, 57
"d:\25cxx\try\v1\internal\session\manager.go", "Go", 0, 4, 0, 4, -1, 7
"d:\25cxx\try\v1\internal\upstream\broadcast_manager.go", "Go", 0, -299, 0, -42, -63, -404
"d:\25cxx\try\v1\internal\upstream\server.go", "Go", 0, -81, 0, -13, -21, -115
"d:\25cxx\try\v1\proto\message.pb.go", "Go", 0, 227, 0, 11, 36, 274
"d:\25cxx\try\v1\proto\upstream.pb.go", "Go", 0, -558, 0, -20, -87, -665
"d:\25cxx\try\v1\proto\upstream_grpc.pb.go", "Go", 0, -27, 0, -4, -4, -35
"d:\25cxx\try\v1\scripts\test_unicast.ps1", "PowerShell", 0, 0, -158, -1, -26, -185
"d:\25cxx\try\v1\scripts\test_unicast.sh", "Shell Script", -106, 0, 0, -3, -19, -128
"Total", "-", -106, -1303, -158, -102, -300, -1969